|-----------------------------------------------------------------------------|
|                                                                             |
| |---------------------|        |------------------------|                   |
| |.....................|        |........................|                   |
| |.....................+########+........................|------|            |
| |.....................|    #   |...............................|--|         |
| |.....................|    #   |..................................|--|      |
| |-------+-------------|    #   |---+-----------------|...............|      |
|         #              #############                 |...............|      |
|         #              #      |----+------|          |...............|      |
|         #              #      |...........|          |...............|      |
|         ################      |...........|     #####+...............|      |
|         #              #      |...........|     #    |...............|      |
|         #              #      |----+------|     #    |-------------+-|      |
|  |------+--------|     #           #            #                  #        |
|  |...............|     #           #            #              |---+----|   |
|  |...............|     ##########################              |........|   |
|  |...............|     #           #                           |........|   |
|  |...............|     #    |------+---------------------------|........|   |
|  |...............|     #    |...........................................|   |
|  |...............+##########+...........................................|   |
|  |...............|          |...........................................|   |
|  |---------------|          |-------------------------------------------|   |
|                                                                             |
|-----------------------------------------------------------------------------|